# # # # # # # # # # 
# @ @ @ @ @ @ # @ # 
# @ # @ # # @ # @ #
# @ # @ # @ @ @ @ #
# # # @ # @ # @ @ #
# # # # # @ # # @ # 
# @ @ @ # @ @ # @ # 
# @ # # # # @ # @ # 
# @ @ @ @ @ @ # @ #
# # # # # # # # # #