# # # # # # # # # #
# @ @ @ @ @ @ @ @ #
# @ @ @ @ @ @ @ @ #
# @ @ @ @ @ @ @ @ #
# @ @ @ @ @ # @ @ #
# @ @ @ @ @ @ @ @ #
# @ @ @ @ @ @ @ @ #
# @ @ @ @ @ @ @ @ #
# @ @ @ @ @ @ @ @ #
# # # # # # # # # #